1 1 1 1 1
1 0 0 4 1
1 3 0 5 1
1 0 0 2 1
1 1 1 1 1