1 1 1 1 1 1 1 1 1 1 1 1 1 1
1 2 0 4 4 4 1 1 2 0 4 4 4 1
1 5 1 5 1 0 5 0 0 5 5 0 0 1
1 4 0 5 0 5 0 0 5 3 0 1 1 1
1 0 0 5 0 0 1 4 0 0 2 0 4 1
1 1 0 0 1 1 1 1 0 0 5 0 0 1
1 2 0 4 4 4 1 1 2 0 4 4 4 1
1 5 1 5 1 0 5 0 0 5 5 0 0 1
1 0 0 5 0 0 1 4 1 1 2 0 4 1
1 1 0 0 1 1 1 1 0 0 5 0 0 1
1 0 0 5 0 0 1 4 1 1 2 0 4 1
1 0 0 5 0 0 1 4 1 1 2 0 4 1
1 5 1 5 1 0 5 0 0 5 5 0 0 1
1 1 1 1 1 1 1 1 1 1 1 1 1 1